.........................
.........................
.........................
.........................
.........................
.........................
...........R.B...........
.=======================.
.=======================.
.=======================.
.........................
.........................
.........................
.........................
............*............
=========================
3
14 0 RRLL
14 1 RLLR
14 2 LLRR
