.........................
.........................
.........................
.........................
.........................
.........................
...........R.B...........
.=======================.
.=======================.
.=======================.
.........................
.........................
.........................
.........................
............*............
=========================
2
14 0 RL 
14 1 LR
